WWWWWWWWWWWWWWWWWWWWWWWWW
W    E       E      E   W
W                 T     W
W  T         T          W
W    E           E      W
W                 T     W
WSSSSFFSSSSSSSSSSSSFFSSSW
WSSSSFFSSSSSSSSSSSSFFSSSW
W                       W
W   T              T    W
W            T          W
WGGGG               GGGGW
W   G       P       G   W
W      T                W
WWWWWWWWWWWWWWWWWWWWWWWWW